  #####
###   #
#.@$  #
### $.#
#.##$ #
#$ .$$.#
#   .  #
########