    #####
    #   #
    #$  #
  ###  $###
  #  $  $ #
### # ### #     ######
#   # ### #######  ..#
# $  $             ..#
##### #### #@####  ..#
    #      ##  #######
    #########