         ########
         #     @#
         # $#$ ##
         # $  $# 
         ##$ $ # 
########## $ # ###
#....   ## $  $  #
##...     $  $   #
#....   ##########
#########
