#############
#..   #     ###
#..   # $  $  #
#..   #$####  #
#..     @ ##  #
#..  # #  $  ##
###### ##$ $  #
  # $  $ $ $  #
  #   #       #
  #############
